0000000000
0111110110
0101010010
0101110110
1101010010
0100111110
0111000010
0100010011
0111110110
0000000000
